On a fresh intall for an easy and nice setup can use LARBS
curl -LO larbs.xyz/larbs.sh; then run as root: bash larbs.sh

===== Custom from fresh install ===== 

Installing i3
    a. Install Xorg: 
            xorg-server | Graphical server
            xorg-xwininfo | tool to query info about windows
            xorg-xinit | starts graphical server
            xorg-xprop | tool for detecting window props 
            xorg-xdpyinfo | Aids with resolution determination
            xorg-xrdb | Allows user of .Xresources
            xorg-xbacklight | enables screen brightness controls
            xf86-video-<graphics> | Grapics driver (to check: lspci | grep -e VGA -e 3D)
            xf86-input-synaptics | driver for touchpad
            copmton | compositor for xorg
            termite | terminal emulator
    b. Install fonts: ttf-dejavu
    c. Install i3: 
            i3-gaps | i3 with gaps
            i3blocks | status bar
            i3lock | screen lock
            dmenu | runs commands and UI selection
            dunst | notification system
            xwallpaper | wallpaper setter
    d. cp /etc/X11/xinit/xinitrc ~/.xinitrc and replace last block with `exec i3`
    d. `startx` then add 'status_command i3blocks' to ~/.config/i3/config 
    e. For inital HiDpi scaling: 
        - add 'Xft.dpi: 192' to ~/.Xresources
        - copy termite config: 'cp /etc/xdg/termite/config ~/.config/termite/' and increase font size
    f. feh --bg-scale path/to/file, then add ~/.fehbg & to ~/.xinitrc
    g. add xrandr --output ${screen} --mode ${resolution}
     
10. Packages to look at: 
    lightDM, slick greeter | mint desktop manager
    ntp | System Clock
    ranger | terminal file manager
    bc | terminal based calculator
    calcurse | terminal based calander 
    dosfstools | allows computer to access dos-like filesystems
    libnotify | allows desktop notifications
    exfat-utils | manage FAT drives
    mpd, mpc | music deamon and cli
    mpv | vidoe player
    ncmpcpp | ncurses music interface
    newsboat | RSS Client
    ntfs-3g | access NTFS partitions
    pulseaudio | audio system
    pusseaudio-alsa | interface with ALSA
    pulsemixer | ncurses audio controller
    socat | socket utility
    tmux | terminal multiplexer (for dropdown terminals)
    unrar, unzip | uncompress files
    xclip | allows copy/paste form command line
    xdotool | window action utilities on command line
    youtube-dl | download youtube vids
    zathura + plugins | document viewer
    poppler | edit pdfs
    mediainfo | shows audio/video information
    atool | manages archives
    fzf | fuzzy finder tool
    highlight | highlight code output
    nmcli-dmenu | manage NetwMan with dmenu networkmanager-demenu-git AUR
